1111111111
1000000001
1000000001
1000000001
100000000111111
100011000000001
100011000000001
100000000000001
100000000000001
111111111111111