111111111111111
100001000010001
100001000001001
100001000010001
100001000100001111111111
100001000100001000100001
100000001000000010000001
100111000000000000000001
100111000000000000000001
100000001110000110011001
100000000000000000000001
111111111111111111111111